(20,20)    ***** map size (rows,columns) *****
MX.....O.M..XX......
.X.XXXXX.X.X...XX.X.
.X....XX.X...XX.....
...XX...X.X.X...X..X
X.XX..X.X.X.XX.XMX..
.....XX.O.X.XF...XX.
XXXXXXXX.XXXXX......
SX.....X.O..M.XX...M
.X.XXX.X.XMF...MXXOX
.......XMXXXXXXOXX.X
.XXXXX.XX....X...X.E
F........X.X..XX.XXX
.XXX.....X.X...X.O..
.XMM.........X.X.X.X
XXXX.......XX.X.X..X
XMO..XXXX........X.M
XXX..XX...XX.X.X.O.X
MXXX.X..X.X..X.X.X.X
..X....X....XM.X.X.X
....XXFXMXXXMMX..XFM
