(20,20) row,col
.X...X..XFXMX...XX..
.MX.X..XXOXOX...X...
.MO.X...X.X.X.X.XX..
.MX..............OM.
OXFXXXXXXXXXX....OM.
OX.....MOOOOO....OM.
EXXXX...XXXXX....OM.
X....X.X....X....XXX
........XXX..XXXXF..
XXXXXXX..........XX.
.......XXXXXXXXX....
..XXXXX...M.XX....X.
.XMMX.FX..X.....XM..
.X..X..X............
.X..XM.X.....XM.X..X
.X........X........M
.X.XXXX.X..........X
........MX...X..X...
..XXXXX.XM.X.......M
S.......X.....X.MXXX
